Jahr	Total Verunfallte	Total Schwerverletzte	Total Leichtverletzte	Total Unfälle	Total Getötete
2006	657	129	528	1836	2
2007	600	118	482	1746	3
2008	583	98	485	1464	6
2009	563	107	456	1350	4
2010	458	96	362	1153	4
2011	388	90	298	948	3
2012	302	81	221	898	5
2013	397	82	315	1029	2
2014	435	88	347	1106	2
2015	470	97	373	1126	3
