Jahr	mit Personenschaden	mit Sachschaden	Total Unfälle	Total Verunfallte	Total Schwerverletzte	Total Leichtverletzte	Total Getötete
2006	572	1264	1836	659	129	528	2
2007	529	1217	1746	603	118	482	3
2008	495	969	1464	589	98	485	6
2009	472	878	1350	567	107	456	4
2010	381	772	1153	462	96	362	4
2011	317	631	948	391	90	298	3
2012	256	642	898	307	81	221	5
2013	327	702	1029	399	82	315	2
2014	374	732	1106	437	88	347	2
2015	391	735	1126	473	97	373	3
